OOOOOOOOOOOOOOOOOOOOOOOOOOOOOOOOOOOOOOOOOOOOOOOOOOOOOOOO
O            OOOOOOOOOO       OO       OO              O
O OO   OO OO OOOOOOOOOOO O O OOOO O O OOO OOOOOOOOOO O O
O OOO OOOOOO OOOOOOOOOOO OOO OOOO OOO OOO OOOOOOOOOO O O
O OOO OOOOOO OOOOOOOOOOO     OOOO     OOO              O
O OOO OOOOOO OOOOOOOOOOO O O OOOO O O OOO OOOOOOOOOO O O
O OOO OOO OO OOOOOOOOOOOOO OOOOOOOO OOOOO OOOOOOOOOO O O
O OOO     OO OOOOOOOOOOOOO OOOOOOOO OOOOO OOOOOOOOOO O O
O OOOOOOO OO OOOOOOOOOOOOO                OOOOOOOOOO   O
O OOOOOOOOOO OOOOOOOOOOOOO OOOOOOO O OOOO OOOOOOOOOO O O
O OOOOOOOOOO OOOOOOOOOOOOO OOOOOOO   OOOO OOOOOOOOOO O O
O OOOOOOOOO   OOOOOOOOOOOO OOOOOOOO OOOOO   OOOOOOOO O O
O           O                  OOOOOOOOOO O  OOOOOOO   O
O OOOOOOOOO   OOOOOOOOOOOO OOO OOOOOOOOOO   OOOOOOOO O O
O OO O OOOOO OOOOOOOOOOOO  OOO OOOOO      OOOOOOOOOO O O
O         OO OOO OO OO OO OO O OOOOO OOOO OOOOOOOOOO O O
O OO O OO OO OO           OO           OO    OOOOOOO   O
O OOOOOOO OO OO OOOOOOOO OOO OOOO OOOO OOOOO OOOOOOO O O
O OOOOOO   O OO          OOOOOOOO OOOOOOOOO   OOOOOO O O
O OOOOOOO OO OOOOOOOOOOO OOOOOO     OOOOOOO O OOOOOO O O
O OOOOOOO OO OOOOOOOOOOO OOOOO  OOO  OOOOOO O          O
O OOOOOO   O OOOOOOOOOOO OOOOOO OOO         O OOOOOO O O
O OO O OO OO             OO OO  OOO  OOOOOO   OOOOOO O O
O       O OO OOOOO O OOO O   OO     OOOOOOOO OOOOOOO O O
O OOOOO O OO OOOOO   OOO O O OOO O OOOOOOOOO OOOOOOO   O
O OO O  O OO OOOOOO OOOO O O OOO O OOOOOOOOO OOOOOOO O O
O O   O O OO OOOOOOOOOOO                     OOOOOOO O O
O O O O O OO OOOOOOOOOOO OOOOOOOOOOO OOO OOOOOOOOOOO O O
O       O                OOOOOOOOOOO OOO OOOOOOOOOOO   O
O OOOOOOO OO OOOOO OOOOO OOOOOOOOO         OOOOOOOOO O O
O OOOOOOO OO OOOO   OOOO OOOOOOOO    OOO    OOOOOOOO O O
O         OO OOOO O OOOO OOOOOOOOO  OOOOO  OOOOOOOOO O O
O OOOOOOO OO OOOO   OOOO OOOOOOOO    OOO    OOOOOOOO   O
OOOOOOOOO OO OOOOO OOOOO OOOOOOOOO         OOOOOOOOO O O
O     OOO                OOOOOOOOOOO OOO OOOOOOOOOOO O O
O O O OOOOOO OOOOOOOO OO OOOOOOOOOOO OOO OOOOOOOOOOO O O
O  O           OOOO   OO                               O
O O O OOOOOO O O OO O OO OOO OOO OOO OOO OOO OOO OOO O O
O     OOOOOOOO      OOOO                               O
OOOOOOOOOOOOOOOOOOOOOOOOOOOOOOOOOOOOOOOOOOOOOOOOOOOOOOOO
