OOOOOOOOOO
O   O    O
O   O O  O
O  OO    O
OO    O  O
OOOOOOOOOO